16 16 45 33
0 0 -1 -1 0 0 5 0 0 -1 -1 -1 0 0 0 -1
0 0 -1 0 0 0 -1 0 0 0 -1 0 0 0 0 0
0 0 F1 0 -1 0 -1 0 -1 0 -1 0 0 0 S1 0
0 -1 -1 -1 -1 0 -1 0 -1 0 0 0 0 0 0 -1
0 0 0 0 -1 0 -1 0 0 -1 F2 -1 0 0 0 -1
0 -1 -1 0 0 0 -1 S 0 -1 0 -1 -1 -1 -1 -1
0 0 -1 -1 -1 0 -1 0 0 0 0 0 0 0 -1 0
0 0 -1 -1 0 0 -1 -1 -1 -1 G1 -1 -1 0 -1 0
0 0 0 0 0 0 0 -1 0 -1 -1 -1 -1 -1 -1 0
0 0 0 -1 -1 0 0 -1 0 7 0 0 0 -1 0 0
0 -1 G 0 0 -1 0 -1 -1 -1 0 -1 0 -1 0 -1
0 -1 0 -1 0 -1 0 0 0 0 0 -1 0 0 0 0
0 -1 0 0 0 -1 -1 -1 -1 0 0 -1 0 -1 -1 0
0 -1 -1 0 -1 10 0 0 0 0 S2 -1 0 0 0 0
0 0 -1 0 0 0 0 -1 0 0 0 0 0 -1 0 -1
-1 0 0 G2 0 0 0 -1 -1 -1 -1 0 -1 -1 -1 -1
