10 10 20 20
0 0 0 -1 0 0 0 0 0 0
0 0 0 -1 0 0 -1 0 G 0
-1 -1 0 -1 0 0 -1 0 0 0
0 0 -1 0 0 0 -1 0 -1 0
0 0 0 -1 -1 -1 4 0 -1 0
F2 0 0 0 0 0 0 2 -1 0
0 -1 -1 -1 0 0 0 0 0 0
0 0 0 0 F4 0 0 0 0 0 
0 0 0 0 0 -1 -1 0 0 0
S 0 0 0 0 0 -1 -1 -1 0