8 8 10 10
0 0 0 0 0 2 0 0
0 S 0 0 0 -1 0 0
0 0 0 0 0 5 0 0
0 3 -1 4 -1 -1 0 0
-1 0 0 0 0 -1 0 0
0 0 0 -1 0 -1 0 0
0 0 0 0 0 -1 G 0
0 0 0 0 0 0 0 0