10 10 15 10
0 0 0 0 0 0 0 0 0 0
0 0 0 0 0 0 0 0 0 0
0 0 0 0 G 0 0 0 0 0
-1 0 0 0 0 0 -1 -1 0 0
0 3 -1 -1 -1 4 0 -1 0 0
0 0 0 0 0 0 0 -1 0 0
0 -1 0 0 0 -1 0 -1 0 0
0 0 S 0 0 -1 0 -1 0 0
0 0 0 0 0 0 0 0 0 0 
0 0 0 0 0 0 0 0 0 0