10 10 20 15
0 0 0 0 0 0 0 -1 0 0
0 F6 0 -1 -1 F3 -1 0 G 0
0 0 -1 0 0 0 2 0 0 0
0 0 -1 0 0 0 0 0 4 0
0 0 -1 F4 -1 -1 -1 0 0 -1
0 0 -1 0 0 0 0 F2 -1 -1
0 0 0 0 0 3 0 0 0 0
0 0 0 0 0 -1 -1 -1 0 0
0 S 0 0 2 0 0 0 F6 0 
0 0 0 0 0 0 0 0 0 0