10 10 16 16
0 -1 0 0 0 0 0 0 0 -1
S 0 -1 -1 0 -1 -1 -1 -1 0
0 0 0 -1 0 0 0 0 3 0 
0 0 0 F4 0 0 0 0 -1 0
-1 0 -1 0 -1 -1 0 -1 -1 0
-1 0 0 0 0 0 -1 0 2 0
-1 0 0 -1 0 0 0 0 0 0 
0 -1 0 0 -1 0 -1 0 0 G
0 0 -1 2 -1 -1 0 -1 -1 0
0 0 0 0 0 0 F9 0 0 0 