8 8 21 10
0 0 0 0 0 -1 0 0
0 S 0 0 0 -1 0 0
0 0 0 0 0 -1 0 0
0 3 -1 4 0 -1 0 G
-1 0 0 0 0 -1 0 0
0 0 0 -1 0 -1 0 0
0 0 -1 0 0 -1 0 0
0 0 0 0 0 -1 0 0