31 28 100 80
0 -1 0 0 0 -1 0 S4 0 0 -1 0 0 F2 0 0 -1 0 0 -1 0 -1 0 0 0 G3 0 -1
-1 -1 0 0 -1 -1 0 0 0 0 -1 -1 0 0 -1 -1 -1 0 0 -1 -1 0 0 -1 0 0 0 0
0 0 0 -1 -1 -1 0 -1 0 0 0 -1 0 -1 -1 0 0 0 -1 0 0 -1 -1 0 0 0 0 -1
0 0 -1 0 0 -1 0 0 -1 -1 -1 -1 0 0 0 -1 -1 -1 -1 -1 0 -1 0 0 -1 0 -1 0
0 -1 0 0 0 0 0 -1 0 -1 0 -1 0 0 0 -1 -1 0 0 0 0 0 0 0 -1 0 0 0
-1 0 -1 -1 0 -1 -1 -1 -1 0 0 -1 0 -1 -1 -1 0 -1 0 0 -1 -1 0 -1 0 0 -1 0
-1 -1 -1 0 0 -1 0 0 0 -1 -1 0 0 0 0 0 0 -1 -1 -1 -1 0 -1 -1 0 -1 0 0
0 0 0 0 -1 -1 -1 0 0 0 -1 0 -1 0 -1 -1 0 0 -1 -1 0 0 -1 -1 0 -1 0 -1
S3 -1 0 -1 -1 -1 0 0 -1 -1 0 -1 -1 -1 -1 0 0 0 0 0 -1 0 -1 0 -1 0 0 -1
-1 0 0 0 0 0 -1 0 0 0 -1 -1 -1 0 -1 0 0 0 0 0 -1 0 -1 -1 0 -1 -1 0
0 0 0 0 0 -1 0 0 0 -1 -1 0 0 0 -1 -1 0 0 0 -1 -1 -1 0 -1 -1 0 -1 0
-1 -1 0 -1 0 0 -1 0 0 S2 -1 0 0 0 0 0 0 0 -1 -1 0 -1 -1 -1 0 -1 0 0
0 0 -1 0 0 0 -1 0 -1 0 0 0 0 0 0 -1 -1 -1 0 -1 0 0 0 0 0 -1 0 -1
0 -1 -1 0 -1 -1 0 -1 0 0 -1 -1 0 -1 F1 0 0 0 -1 0 0 0 -1 0 -1 -1 0 -1
0 -1 0 -1 0 -1 -1 0 0 0 0 -1 -1 -1 -1 0 0 -1 -1 -1 0 -1 -1 -1 -1 -1 0 -1
-1 0 0 0 -1 0 -1 -1 -1 -1 0 0 0 -1 -1 0 -1 -1 0 0 0 -1 0 -1 -1 0 -1 0
0 -1 0 -1 0 0 0 -1 -1 -1 0 0 0 -1 0 -1 0 0 -1 0 -1 0 0 0 -1 0 0 -1
-1 -1 0 0 -1 -1 -1 0 0 -1 -1 0 0 0 -1 -1 -1 0 0 -1 -1 -1 -1 0 -1 -1 -1 0
0 G1 -1 -1 -1 0 0 0 0 0 -1 -1 0 -1 0 0 0 0 -1 -1 0 0 0 0 0 0 -1 0
0 0 -1 -1 -1 0 -1 0 -1 -1 0 -1 0 -1 -1 -1 -1 0 -1 -1 0 -1 0 -1 0 -1 0 -1
0 0 0 -1 0 0 0 0 0 -1 -1 -1 -1 -1 10 -1 0 -1 0 -1 0 -1 0 -1 0 0 -1 -1
-1 -1 0 0 0 0 -1 0 -1 0 -1 -1 -1 0 0 -1 0 0 -1 -1 0 -1 0 -1 -1 -1 0 -1
-1 G4 0 -1 -1 -1 0 0 -1 0 -1 -1 -1 0 0 0 -1 -1 0 0 0 0 -1 -1 -1 -1 -1 -1
-1 0 0 0 -1 -1 -1 -1 0 -1 -1 0 -1 0 -1 -1 0 S1 0 0 0 -1 -1 0 -1 -1 0 -1
-1 -1 0 -1 0 0 -1 0 -1 -1 0 G 0 -1 -1 0 0 -1 -1 0 0 0 -1 0 -1 -1 -1 0
-1 -1 0 -1 -1 0 -1 0 -1 0 -1 0 -1 0 -1 -1 -1 -1 -1 -1 15 -1 0 0 -1 -1 0 -1
0 0 -1 -1 -1 -1 -1 0 -1 -1 -1 0 -1 -1 -1 0 -1 -1 -1 S5 0 0 0 -1 -1 -1 -1 0
0 -1 0 -1 0 -1 0 0 -1 -1 0 -1 0 -1 -1 0 0 0 -1 0 0 0 -1 -1 -1 -1 -1 -1
-1 -1 -1 -1 0 0 0 -1 0 -1 0 -1 -1 0 0 -1 -1 -1 0 -1 0 0 -1 -1 0 -1 0 20
0 -1 0 0 -1 G5 -1 -1 -1 0 0 -1 0 -1 -1 -1 -1 -1 -1 -1 0 -1 0 0 -1 0 0 0
G2 -1 -1 -1 0 -1 0 0 -1 0 -1 0 -1 0 -1 -1 0 0 0 0 0 0 -1 -1 0 0 -1 0